1111111111
10E000C001
1C00000P01
1000000001
1000000001
1000000001
1000000001
1000000001
1000000001
1111111111