1111111111
11E000C001
1C10100P01
1100000011
1111111111