000000111001110000
000111111001111100
000111111111111100
000011111111111000
000001111111110000
000000111111100000
000000011111000000
000000001110000000
000000000100000000
